1111111111111
10C0111111001
1C01111110011
1000111111001
1PC000C0000E1
1111111111111
