111111111111111111
10000P000001111E11
110000001111010011
11C000000C10010011
110000C00000000011
111111111111111111
