11111111
1E0110P1
100CC001
11111111
