1111111111111111111111
1010C01111101110101111
1010101110000000111C11
1000000P00000000001011
1011101011111010111011
1111111011101010001011
100011100C001010111011
1010101011111110101011
1110111010001010111011
1000C00C101010000C00E1
1111111111111111111111
