1111111111111111111111111111111111
1E00000000000C00000000000000000001
1000010100100000101001000000010101
1000010100100000101001000000010101
1000010100100000101001000000010101
1000010100100000101001000000010101
1000010100100000101001000000010101
1000010100100000101001000000010101
1000010100100000101001000000010101
1000010100100000101001000000010101
1000010100100000101001000000010101
1000010100100000101001000000010101
1000010100100000101001000000010101
1000010100100000101001000000010101
1000010100100000101001000000010101
1000010100100000101001000000010101
1000010100100000101001000000010101
1000010100100000101001000000010101
100C01001010101C001001000000010101
1P000000000C0000000000000000000001
1111111111111111111111111111111111
